Date,Description,Amount,Balance
2025-01-01,Salary Payment,3000.0,3000.0
2025-01-05,ATM Withdrawal,-200.0,2800.0
2025-01-10,Grocery Store,-150.5,2649.5
2025-01-15,Utility Bill,-100.0,2549.5
2025-01-20,POS Purchase,-75.0,2474.5
2025-01-25,Salary Payment,3000.0,5474.5